11111111
1C1CCCP1
1EC11001
11111111