11111111
1C1CCCP1
1ECC1001
11111111