11111111
1C101CP1
1E0C1001
11111111