11111111
1C1CCCP0
1ECC1001
11111111